{
	"title": "Operation FUBAR",
	"width": 31,
	"height": 32,
	"author": "kain@piwnica.ws",
	"mode": "conquest",
	"tiles": [
		"...............................",
		".s---------------------------s.",
		".|    1    1     1    1      |.",
		".s    #    #     #    #      s.",
		".|    #################      |.",
		".s    #       #       #      s.",
		".|    #       #       #      |.",
		".s-s-s#s-s-s-s#s-s-s-s#s-s-s-s.",
		".|    #       #  | |  #      |.",
		".|    #       #  S S  #      |.",
		".S 2  #C   2  ###########  2 S.",
		".|    #       #  S S  C #    |.",
		".|    #       #  | |    #    |.",
		".S-S-S#S-S-S-S#S-S S-S-S#S-S-S.",
		".     #       #         #     .",
		".     #       #C        #     .",
		".     #       ###       #     .",
		".     #         #       #     .",
		".S-S-S#S-S-S S-S#S-S-S-S#S-S-S.",
		".|    #    | |  #       #    |.",
		".|    # C  S S  #       #    |.",
		".S 2  ###########  2   C#  2 S.",
		".|      #  S S  #       #    |.",
		".|      #  | |  #       #    |.",
		".S-S-S-S#S-S-S-S#S-S-S-S#S-S-S.",
		".|      #       #       #    |.",
		".S      #       #       #    S.",
		".|      #################    |.",
		".S      #    #     #    #    S.",
		".|      2    2     2    2    |.",
		".S---------------------------S.",
		"..............................."
	],

	"controlPoints": [
		{
			"name": "Green hangars",
			"capture": [7, 10],
			"polygon": [[1,8], [17,8], [17,13], [1,13]]
		},
		{
			"name": "Green helipad",
			"capture": [22,11],
			"polygon": [[19,8], [29,8], [29,13], [19,13]]
		},
		{
			"name": "Courtyard",
			"capture": [15,15],
			"polygon": [[1,14], [29,14], [29,17], [1,17]]
		},
		{
			"name": "Brown helipad",
			"capture": [8,20],
			"polygon": [[1,18],[11,18],[11,23],[1,23]]
		},
		{
			"name": "Brown hangars",
			"capture": [23,21],
			"polygon": [[13,18],[29,18],[29,23],[13,23]]
		}
	]
}
