{
	"title": "Operation FUBAR",
	"width": 33,
	"height": 34,
	"author": "kain@piwnica.ws",
	"mode": "conquest",
	"tiles": [
		".................................",
		".                               .",
		". s---------------------------s .",
		". |    1    1     1    1      | .",
		". s    #    #     #    #      s .",
		". |    #################      | .",
		". s    #       #       #      s .",
		". |    #       #       #      | .",
		". s-s-s#s-s-s-s#s-s-s-s#s-s-s-s .",
		". |    #       #  | |  #      | .",
		". |    #       #  s s  #      | .",
		". s 1  #c   1  ###########  1 s .",
		". |    #       #  s s  c #    | .",
		". |    #       #  | |    #    | .",
		". s-s-s#s-s-s-s#s-s s-s-s#s-s-s .",
		".      #       #         #      .",
		".      #       #o        #      .",
		".      #       ###       #      .",
		".      #         #       #      .",
		". S-S-S#S-S-S S-S#S-S-S-S#S-S-S .",
		". |    #    | |  #       #    | .",
		". |    # C  S S  #       #    | .",
		". S 2  ###########  2   C#  2 S .",
		". |      #  S S  #       #    | .",
		". |      #  | |  #       #    | .",
		". S-S-S-S#S-S-S-S#S-S-S-S#S-S-S .",
		". |      #       #       #    | .",
		". S      #       #       #    S .",
		". |      #################    | .",
		". S      #    #     #    #    S .",
		". |      2    2     2    2    | .",
		". S---------------------------S .",
		".                               .",
		"................................."
	],

	"controlPoints": [
		{
			"name": "Blue west",
			"capture": [8, 11],
			"polygon": [[2,9], [18,9], [18,14], [2,14]]
		},
		{
			"name": "Blue east",
			"capture": [23,12],
			"polygon": [[20,9], [30,9], [30,14], [20,14]]
		},
		{
			"name": "Courtyard",
			"capture": [16,16],
			"polygon": [[2,15], [30,15], [30,18], [2,18]]
		},
		{
			"name": "Red west",
			"capture": [9,21],
			"polygon": [[2,19],[12,19],[12,24],[2,24]]
		},
		{
			"name": "Red east",
			"capture": [24,22],
			"polygon": [[14,19],[30,19],[30,24],[14,24]]
		}
	]
}
