{
	"title": "Operation SNAFU",
	"width": 128,
	"height": 9,
	"author": "kain@piwnica.ws",
	"mode": "conquest",
	"tiles": [
		"................................................................................................................................",
		".       s                     s--s--s--s--s              $--$--$--$--$               S--S--S--S--S                    S        .",
		".  1##  -                     -  1  1  1  -              -  0  0  0  -               -  2  2  2  -                    -  ###2  .",
		".    #  s                     s  #  #  #  s              $  #  #  #  $               S  #  #  #  S                    S  #     .",
		".  1########################################################################################################################2  .",
		".    #  s                     s     #     s              $     #     $               S     #     S                    S  #     .",
		".  1##  -                     -     c     -              -     o     -               -     C     -                    -  ###2  .",
		".       s                     s--s--s--s--s              $--$--$--$--$               S--S--S--S--S                    S        .",
		"................................................................................................................................"
	],

	"controlPoints": [
		{
			"name": "Left",
			"capture": [36, 6],
			"polygon": [[30,1], [42,1], [42,7], [30,7]]
		},
		{
			"name": "Center",
			"capture": [63,6],
			"polygon": [[57,1], [69,1], [69,7], [57,7]]
		},
		{
			"name": "Right",
			"capture": [91,6],
			"polygon": [[85,1], [97,1], [97,7], [85,7]]
		}
	]
}
