....................
....................
..                ..
..  2##########F  ..
..       #        ..
..--S--S-#-S---S--..
..       #        ..
..       #        ..
..       #        ..
..       ##       ..
..       ##       ..
..        #       ..
..        #       ..
..        #       ..
..--s---s-#-s--s--..
..        #       ..
..  f##########1  ..
..                ..
....................
....................